NO ./textures/brick.xpm
SO ./textures/blue.xpm
WE ./textures/wood.xpm
EA ./textures/grey.xpm
F 220,100,0
C 225,30,0
        1111111111111111111111111
        1000000000000000000000001
        1011000000000000000000001
        1001000000000000000000001
111111111011000S00000000000000001
100000000000000000000000000011111
11110111111111011100000010001
11110111111111011101010010001
11000000110101011100000010001
10000000000000001100000010001
10000000000000001101010010001
1100000111010101111101111000111
11110111 1110101 101111010001
11111111 1111111 111111111111